22nya	dua-duanya
7an	tujuan
aahh	ah
aama	sama
aamien	amin
aamiin	amin
aamiinin	amin
aamin	amin
ababil	abg labil
abal "	abal-abal
abanggku	abangku
abes	habis
abez	habis
abg	abang
abgnya	abangnya
abgnyaah	abangnya
abis	habis
abis-abis	habis-habis
abiss	habis
abiz	habis
acra	acara
adaa	ada
adain	mengadakan
adapin	menghadapi
ade	adik
adek	adik
adek-adek	adik-adik
adeknya	adiknya
adekx	adiknya
adem	sejuk
ademm	sejuk
adengan	adegan
adeuh	aduh
adiik	adik
adkah	adakah
adl	adalah
adlah	adalah
adlh	adalah
adoh	aduh
aduhh	aduh
aduuh	aduh
aduuhh	aduh
adyem	sejuk
ae	saja
aee	saja
aelah	halah
aer	air
afaik	as far as i know
agama ' ny	agamanya
agan	juragan
agan-agan	juragan-juragan
agk	agak
agma	agama
ahaha	haha
ahahahanjir	anjir
ahh	ah
aing	aku
aj	saja
aja	saja
ajaa	saja
ajah	saja
ajaibb	ajaib
ajakin	mengajak
ajarin	ajarkan
aje	saja
ajep-ajep	dunia gemerlap
ajh	saja
ajha	saja
ajhh	saja
ajibb	ajaib
ajj	saja
ajja	saja
ajjh	saja
ak	ah
ak	aku
aka	dikenal juga sebagai
akau	aku
akhirt	akhirat
akhlah	akhlak
akhrt	akhirat
akika	aku
akko	aku
akkoh	aku
akku	aku
akn	akan
akuh	aku
akuhh	aku
akuu	aku
akuwh	aku
akyu	aku
alaami	alami
alamii	alami
alay	norak
alhamd	alhamdulillah
alissnyaa	alisnya
aljasa	asal jadi saja
alkhamdulilah	alhamdulillah
allaahh	allah
allahh	allah
alloh	allah
alm	almarhum
almh	almarhumah
aloh	allah
alow	halo
ama	sama
amaat	amat
amad	amat
amatt	amat
ambilin	ambilkan
ambl	ambil
ameen	amin
amen	amin
amfun	ampun
amien	amin
amiend	amin
amienn	amin
amiien	amin
amiin	amin
amiinn	amin
aminn	amin
aminn-aminn	amin-amin
ammin	amin
amoh	kamu
ampe	sampai
ampunn	ampun
ampuun	ampun
ampuunn	ampun
ampyun	ampun
amu	kamu
anak "	anak-anak
anak ' y	anaknya
anak2e	anak-anaknya
anak2mu	anak-anakmu
anak2nya	anak-anaknya
anakny	anaknya
anakx	anaknya
ancur	hancur
anda	kamu
aned	banget
anedh	banget
aneed	banget
aneut	banget
anj	anjing
anjaayy	anjay
anjingnyaa	anjingnya
anjirr	anjir
anjr	anjir
anjrit	anjing
ank	anak
ank "	anak-anak
ank-ank	anak-anak
ank2nya	anak-anaknya
ankknya	anaknya
anknya	anaknya
ankx	anaknya
anter	antar
anugrah	anugerah
anyeng	anjing
anying	anjing
ap	apa
ap-ap	apa-apa
apa "	apa-apa
apa2nya	apa-apanya
apaa	apa
apaalahh	apalah
apaan	apa
apah	apa
apal	hapal
apalai	apalagi
apalg	apalagi
apalgi	apalagi
apasih	apa sih
ape	apa
apes	sial
aplikasiin	mengaplikasikan
aplks	aplikasi
aplot	unggah
apo	apa
app	aplikasi
appa	apa
applikasi	aplikasi
apus	hapus
apva	apa
aq	aku
aqu	aku
aquwh	aku
argh	ah
artis "	artis-artis
artisnyaa	artisnya
artist "	artis-artis
artix	artinya
asbun	asal bunyi
aseek	asyik
aseekk	asyik
asek	asyik
asekk	asyik
aseknya	asyiknya
asem	asam
asik	asyik
aslinyo	aslinya
asoy	asyik
aspal	asli tetapi palsu
astafirullah	astaghfirullah
astagaa	astaga
astagfirrullah	astaghfirullah
astagfirullah	astaghfirullah
astagfirullh	astaghfirullah
astajim	astaghfirullah
astauviruloh	astaghfirullah
astgfrlh	astaghfirullah
astgfrullah	astaghfirullah
astrojim	astaghfirullah
astul	asal tulis
asu	anjing
atassan	atasan
ati "	hati-hati
ati-ati	hati-hati
ato	atau
ats	atas
atu	satu
atuhh	atuh
atutt	takut
atuu	satu
atuuh	atuh
atw	atau
au ah	tidak mau tahu
aurot	aurat
ava	avatar
awaas	awas
awak	aku
awk	aku
awl	awal
awooh	allah
aws	awas
ay	sayang
ayahh	ayah
ayang	sayang
ayank	sayang
ayok	ayo
ayoklaa	ayolah
ayoo	ayo
ayuk	ayo
ayukk	ayo
aza	saja
azaab	azab
azek	asyik
b-b	berdua
b2an	berduaan
b3	bertiga
b4	sebelum
baaiik	baik
baang	abang
baanget	banget
baanggeet	banget
babget	banget
bacahalah	bacalah
bacotin	bacot
badaai	badai
badaii	badai
badingkan	membandingkan
bae-bae	baik-baik
baek	baik
baek-baek	baik-baik
bagaatt	banget
bagaimna	bagaimana
baget	banget
bagiin	membagikan
bagusnye	bagusnya
baguss	bagus
baguus	bagus
baikk	baik
baikxa	baiknya
baju ' a	bajunya
baju . a	bajunya
bakalan	akan
bales	balas
balesin	membalas
bandes	bantuan desa
bandingin	bandingkan
bang	abang
bangat	banget
bangcat	bangsat
bangdes	pembangunan desa
banged	banget
bangedd	banget
bangedh	banget
bangedt	banget
bangeer	banget
bangeet	banget
bangeett	banget
banger	banget
bangets	banget
bangett	banget
bangg	abang
bangga " in	membangga-banggakan
bangga2in	membangga-banggakan
banggain	banggakan
bangget	banget
banggett	banget
bangke	bangkai
bangkotan	tua
bangkret	bangkrut
bangrt	banget
bangshad	bangsat
bangt	banget
bangt "	banget-banget
banhet	banget
banpol	bantuan polisi
banpres	bantuan presiden
banpur	bantuan tempur
bansarkas	bantuan sarana kesehatan
bante	membantai
bantuanny	bantuannya
bantuim	membantu
banyaak	banyak
banyakin	membanyaki
bape	bawa perasaan
bapeerr	bawa perasaan
baper	bawa perasaan
baperr	bawa perasaan
baraang	barang
bareng-bareng	bersama-sama
barengg	bersama
baruu	baru
basbang	basi
basodaraa	bersaudara
bat	banget
batesin	batasi
batikk	batik
batwc	banget
bawa "	bawa-bawa
bayangin	bayangkan
bazengg	bajingan
bbrp	beberapa
bbrpa	beberapa
bcanda	bercanda
bcnda	bercanda
bcoz	karena
bdampingan	berdampingan
bdan	badan
bdg	bandung
bdn	badan
beb	sayang
bebrp	beberapa
bedaa	beda
bedain	membedakan
bedainnya	membedakannya
bedua	berdua
begajulan	nakal
begete	banget
beginii	begini
bego	bodoh
begok	bodoh
bejibun	banyak
bejilbbnya	berjilbabnya
bela " in	membela-bela
bela2in	membela-bela
belain	membela
belanjaa	belanja
beliin	membelikan
belin	membelikan
bellain	membela
belom	belum
belomm	belum
beluumm	belum
benahin	membenahi
benar "	benar-benar
benarin	membenarkan
bencong	banci
bener	benar
bener "	benar-benar
bener-bener	benar-benar
beneraan	benaran
beneran	benaran
benerr	benar
benet	benar
benetaran	benaran
benneerr	benar
bentar	sebentar
bentarr	sebentar
ber ' expresi	berekspresi
ber-ber	berdua
ber3	bertiga
berangat	berangkat
berani2nya	berani-beraninya
berarto	berarti
berati	berarti
beratt	berat
berbakiti	berbakti
berdikari	berdiri di atas kaki sendiri
berenanh	berenang
beresin	membereskan
berfikir	berpikir
bergunaa	berguna
berhijap	berhijab
berjinah	berzina
berkluarga	berkeluarga
bermaksut	bermaksud
berntung	beruntung
bertatto	bertato
bertolernsi	bertoleransi
besar "	besar-besar
besarin	membesarkan
besokk	besok
besook	besok
bet	banget
bete	bosan
beti	beda tipis
bett	banget
beud	banget
beudd	banget
beut	banget
bg	abang
bgd	banget
bgect	banget
bget	banget
bgett	banget
bgi	bagi
bgini	begini
bgitu	begitu
bgmana	bagaimana
bgmn	bagaimana
bgmna	bagaimana
bgni	begini
bgs	bagus
bgst	bangsat
bgt	banget
bgtt	banget
bgtu	begitu
bgtuu	begitu
bgun	bangun
bgus	bagus
bguss	bagus
bhagaia	bahagia
bhagia	bahagia
bhas	bahas
bhet	banget
bhgia	bahagia
bhgiain	membahagiakan
bhijab	berhijab
bhkn	bahkan
bhn	bahan
bhubu	tidur
bhw	bahwa
bhwa	bahwa
biarin	biarkan
biasaa	biasa
biasahh	biasa
bijimane	bagaimana
bijin	buat
bikinin	buatkan
bikinn	buatkan
bilang "	bilang-bilang
bilangg	bilang
bilangin	bilangkan
bilanh	bilang
bilng	bilang
bimbuluh	bimbingan dan penyuluhan
binggo	benar
bingitz	banget
bintal	bimbingan mental
bisaa	bisa
bisax	bisanya
bisi	kalau-kalau
biza	bisa
bju	baju
bka	buka
bkal	akan
bkan	bukan
bkin	membuat
bkl	akan
bkln	akan
bkn	bukan
bknnya	bukannya
blajar	belajar
blakon	berlakon
blegug	bodoh
bleh	boleh
blg	bilang
blh	boleh
bli2n	membeli-belikan
bljr	belajar
blkang	belakang
blkng	belakang
blm	belum
bln	bulan
blng	bilang
blnja	belanja
blogh	bodoh
blom	belum
bls	balas
blum	belum
bnchi	benci
bnci	benci
bnda	bunda
bner	benar
bner "	benar-benar
bner-bner	benar-benar
bnerr	benar
bngatt	banget
bngeet	banget
bnget	banget
bngett	banget
bngkit	bangkit
bngt	banget
bngtt	banget
bngtz	banget
bngun	bangun
bngung	bingung
bngunlah	bangunlah
bngy	banget
bnr	benar
bnr-bnr	benar-benar
bntar	sebentar
bntr	sebentar
bntu	bantu
bnyak	banyak
bnyk	banyak
bo ' ong	bohong
bodho	bodoh
bodhoo	bodoh
bodor	lucu
bokap	ayah
bokep	video porno
boker	berak
bokin	pacar
bokis	bohong
bol3h	boleh
bolang	bocah petualang
bole	boleh
boljug	boleh juga
bolot	bodoh
bonek	bocah nekat
bonyok	ayah ibu
boong	bohong
boro-boro	jangankan
bosaan	bosan
bosen	bosan
bosen-bosen	bosan-bosan
bosenin	membosankan
botakin	botaki
botakk	botak
boyeh	boleh
bpk	bapak
bpkmu	bapakmu
bpknya	bapaknya
br	baru
bradegan	beradegan
brangnya	barangnya
brani	berani
branjak	beranjak
brantem	berantem
brapa	berapa
brarti	berarti
brasa	berasa
brb	segera kembali
brbakti	berbakti
brbuat	berbuat
brdiri	berdiri
brdua	berdua
brengsekk	brengsek
brhasil	berhasil
brhjb	berhijab
brisi	berisi
brita	berita
britanya	beritanya
brjdh	berjodoh
brjodoh	berjodoh
brkunjun	berkunjung
brngkt	berangkat
brp	berapa
brpa	berapa
brpndapat	berpendapat
brrt	berarti
brrti	berarti
brsama	bersama
brsyukur	bersyukur
brtngkar	bertengkar
bru	baru
brubah	berubah
brusaha	berusaha
bs	bisa
bsa	bisa
bsen	bosan
bsk	besok
bsok	besok
btuh	butuh
btul	betul
btulan	betulan
btw	by the way
bu_bu	tidur
buanget	banget
buanyak	banyak
buatin	buatkan
bubarin	bubarkan
bubbu	tidur
buber	buka bersama
bubu	tidur
bujngn	bujangan
bujubune	luar biasa
buka2an	buka-bukaan
bukan ' a	bukannya
bukn	bukan
buktiin	buktikan
buktinyaa	buktinya
bulet	bulat
bumil	ibu hamil
bund	ibu
bundaa	ibu
bungg	bung
bungkusin	bungkuskan
bungkuss	bungkus
bungkuus	bungkus
burem	buram
busedh	buset
buseett	buset
buser	buru sergap
bw	bawa
bwa "	bawa-bawa
bwhn	bawahan
bwt	buat
byak	banyak
byangin	bayangkan
byar	bayar
byaran	bayaran
byk	banyak
byr	bayar
byrin	bayarkan
bz	bisa
caannttiikk	cantik
caantiikk	cantik
caantik	cantik
caantikk	cantik
cabal	sabar
cabe2an	cabe-cabean
cabol	cabul
cabut	pergi
cadas	keren
cadass	keren
caem	cakep
cakeep	cakep
cakeepp	cakep
cakepp	cakep
cama-cama	sama-sama
campurin	campurkan
canntik	cantik
canntikk	cantik
cans	cantik
canteek	cantik
cantiik	cantik
cantiiknyaa	cantiknya
cantik2nya	cantik-cantiknya
cantikk	cantik
cantikknyaa	cantiknya
cantiknyaa	cantiknya
cantiks	cantik
cantikx	cantiknya
cantinya	cantiknya
cantiq	cantik
cantiqs	cantik
cantix	cantik
cantk	cantik
capcus	pergi
cape	capek
capee	capek
caper	cari perhatian
caranga	caranya
cariin	carikan
carmuk	cari muka
catiik	cantik
cba	coba
ccok	cocok
cemburuu	cemburu
cemplungin	masukkan
cempreeng	cempreng
cengengesan	tertawa
centill	centil
centilnyaa	centilnya
ceper	pendek
cepet	cepat
cepet-cepet	cepat-cepat
cerdass	cerdas
cerdiik	cerdik
ceritax	ceritanya
cewe	cewek
cewer	jewer
chelalyyu	selalu
chuyunk	sayang
ciapa	siapa
cibuk	sibuk
ciee	cie
cimeng	ganja
cin	cinta
cini	sini
cinlok	cinta lokasi
cintaa	cinta
cintax	cintanya
ciptain	ciptakan
ciumman	ciuman
cius	serius
ciye	cie
ciyee	cie
ciyuss	serius
ckepp	cakep
ckup	cukup
cmkn	camkan
cmpr	campur
cmpur	campur
cnenk	senang
cntiikk	cantik
cntik	cantik
cntikk	cantik
cntiknya	cantiknya
cobaa	coba
coccokk	cocok
cocokk	cocok
cocokny	cocoknya
cocokx	cocoknya
coeg	jancuk
cogan	cowok ganteng
comen2nya	komentar-komentarnya
coment	komentar
comment2nya	komentar-komentarnya
cong	banci
congor	mulut
coret "	coret-coret
cowo	cowok
coz	karena
cpet	cepat
cpit	sipit
cpt	cepat
cr	cara
cri	cari
critamu	ceritamu
cuantek	cantik
cuanti	cantik
cuantik	cantik
cuantikk	cantik
cuco	cocok
cucok	cocok
cucokk	cocok
cuman	hanya
cupu	culun
curhat	curahan hati
cuyy	cuy
cwe	cewek
cwek	cewek
cwo	cowok
cwok	cowok
cz	karena
dalem	dalam
dallam	dalam
damang	sehat
dapet	dapat
darpada	daripada
dasaar	dasar
dasarr	dasar
dasyat	dahsyat
dateng	datang
dblkang	di belakang
dblkng	di belakang
dbnding	dibanding
dbuat	dibuat
dbwh	di bawah
dcintai	dicintai
ddlm	di dalam
ddpat	didapat
ddpt	didapat
dech	deh
dede	adik
dedek	adik
dedeknya	adiknya
dehat	sehat
dek	adik
deket	dekat
deketin	dekati
dekt	dekat
demen	suka
dengeerin	dengarkan
denger	dengar
dengeriin	dengarkan
dengerin	dengarkan
dewassa	dewasa
dgn	dengan
dgr	dengar
dhpusin	dihapuskan
diaa	dia
diajarin	diajari
diakibtkn	diakibatkan
diam "	diam-diam
diancurin	dihancurkan
dianter	diantar
diapain	diapakan
dibangga ' in	dibangga-banggakan
dibanggain	dibanggakan
dibiarin	dibiarkan
dibikin-bikin	dibuat-buat
dibkatakan	dikatakan
dibls	dibalas
dibnggain	dibanggakan
didapet	didapat
didatengin	didatangi
didengerin	didengarkan
diem	diam
diemin	diamkan
diemm	diam
digabtikan	digantikan
digambarin	digambarkan
diginiin	dibeginikan
diginikan	dibeginikan
digituin	dibegitukan
digosipin	digosipkan
dihargain	dihargai
dihh	dih
dihpus	dihapus
diingetin	diingatkan
dijadiin	dijadikan
dijelekin	dijelekkan
dijkt	dijakarta
dijwb	dijawab
dikata2in	dikata-katai
dikatain	dikatai
dikemanain	dikemanakan
dikerasin	dikerasi
diliat	dilihat
diliatnya	dilihatnya
dilindungin	dilindungi
diluarann	diluaran
dimaafin	dimaafkan
dimana "	dimana-mana
dimarahin	dimarahi
dimasukin	dimasuki
dimintak	diminta
dimusiumin	dimuseumkan
dinamakn	dinamakan
dingin "	dingin-dingin
dinyanyiin	dinyanyikan
dipake	dipakai
dipermainin	dipermainkan
dipikirin	dipikirkan
diputusin	diputuskan
dirmh	dirumah
dirumahny	dirumahnya
disinii	disini
disni	disini
ditayangin	ditayangkan
ditutupin	ditutupi
dituutup	ditutup
diuber	dikejar
diurusin	diurusi
dkat	dekat
dket	dekat
dkit	sedikit
dlam	dalam
dlm	dalam
dlu	dulu
dluar	diluar
dmana	dimana
dmn	dimana
dmna	dimana
dngan	dengan
dngn	dengan
doaang	saja
doang	saja
doank	saja
dodol	bodoh
doeloe	dulu
dosa2mu	dosa-dosamu
dosaa	dosa
dosax	dosanya
dpke	dipakai
dpn	depan
dposisi	diposisi
dpotong	dipotong
dpt	dapat
dptkan	dapatkan
dptnya	dapatnya
dramaa	drama
dri	dari
drii	dari
drimana	darimana
drimnanya	darimananya
dripada	daripada
dripda	daripada
drmana	darimana
drmn	darimana
drpada	daripada
drpd	daripada
drtd	dari tadi
dsana	disana
dsar	dasar
dsini	disini
dsna	disana
dsni	disini
dsr	dasar
dsrny	dasarnya
dteng	datang
dtg	datang
dtggu	ditunggu
dtinggl	ditinggal
dtnggu	ditunggu
dtunggu	ditunggu
duh	aduh
duhh	aduh
duit	uang
duluu	dulu
eakyu	waktu
edaan	gila
edan	gila
edann	gila
eike	aku
eke	aku
eksprsi	ekspresi
elo	kamu
elu	kamu
emak-emak	ibu-ibu
emakx	ibunya
emang	memang
emangnya	memangnya
emank	memang
emez	gemas
emezz	gemas
emg	memang
emng	memang
emngnya	memangnya
emnknya	memangnya
endak	tidak
engga	tidak
enggak	tidak
entar	nanti
expresi	ekspresi
eyke	aku
fakultass	fakultas
fhoto	foto
fhotonya	fotonya
fikiran	pikiran
fillm	film
filmny	filmnya
fotbar	foto bareng
foto2nya	foto-fotonya
fotony	fotonya
g	tidak
ga	tidak
gaada	tidak ada
gabisa	tidak bisa
gadiss	gadis
gaharus	tidak harus
gaje	tidak jelas
gajelas	tidak jelas
gak	tidak
gak papa	tidak apa-apa
gakk	tidak
gakpapa	tidak apa-apa
gakuat	tidak kuat
gakusah	tidak usah
gakwad	tidak kuat
gamau	tidak mau
gambarin	gambarkan
gan	juragan
gans	ganteng
ganteeng	ganteng
gantengg	ganteng
ganteung	ganteng
gantheng	ganteng
gantng	ganteng
gantweng	ganteng
gapake	tidak pakai
gapapa	tidak apa-apa
gapernah	tidak pernah
gaptek	gagap teknologi
gapunya	tidak punya
gara "	gara-gara
gara ' '	gara-gara
gasalah	tidak salah
gasih	tidak sih
gatau	tidak tahu
gataunya	tidak tahunya
gatek	gagap teknologi
gatot	gagal total
gausa	tidak usah
gausah	tidak usah
gawe	kerja
gayany	gayanya
gayax	gayanya
gbs	tidak bisa
geer	gede rasa
geje	tidak jelas
gelo	gila
gemay	gemas
gemaz	gemas
gemeez	gemas
gemeezz	gemas
gemes	gemas
gemesiin	menggemaskan
gemesin	menggemaskan
gemesinn	menggemaskan
gemesnya	gemasnya
gemess	gemas
gemesshh	gemas
gemez	gemas
gemezz	gemas
gemmeezz	gemas
geulis	cantik
gilaa	gila
gilak	gila
gilakk	gila
gile	gila
gils	gila
gimana	bagaimana
gimanaa	bagaimana
gimn	bagaimana
gimna	bagaimana
gini	begini
ginian	beginian
ginii	begini
gitchu	begitu
githu	begitu
gitu	begitu
gituan	begituan
gituh	begitu
gitulah	begitulah
gituu	begitu
gk	tidak
gkkan	tidak akan
gksalah	tidak salah
gmana	bagaimana
gmanapun	bagaimanapun
gmau	tidak mau
gmn	bagaimana
gmna	bagaimana
goblog	bodoh
goblok	bodoh
gosipin	menggosipkan
gpny	tidak punya
gpp	tidak apa-apa
gr-gr	gara-gara
gra-gra	gara-gara
gretong	gratis
gretongan	gratisan
grgr	gara-gara
grunya	gurunya
gtau	tidak tahu
gthu	begitu
gtu	begitu
gtu-gtu	begitu-gitu
gtuh	begitu
gtuu	begitu
gtw	tidak tahu
gua	aku
guaa	aku
guanteng	ganteng
gue	aku
guee	aku
guoblok	bodoh
gw	aku
hadirr	hadir
hallo	halo
hallow	halo
haloo	halo
halow	halo
hancurin	hancurkan
hapusin	hapuskan
hayal	khayal
hayalanku	khayalanku
hayoo	ayo
hayuk	ayo
hayuu	ayo
hbis	habis
hdp	hidup
hdpnya	hidupnya
hdup	hidup
hebaat	hebat
hebatt	hebat
heii	hai
hello	halo
helloo	halo
hellow	halo
helo	halo
hianatin	khianati
hidupx	hidupnya
hilangv	hilang
himana	bagaimana
hlm	halaman
hmpir	hampir
hndak	hendak
hndk	hendak
hngga	hingga
hny	hanya
hnya	hanya
hpus	hapus
hrs	harus
hrsny	harusny
hrsnya	harusnya
hrus	harus
hrusnya	harusnya
hslnya	hasilnya
hubngan	hubungan
hubunggi	hubungi
hujatann	hujatan
ibliss	iblis
idamann	idaman
idung	hidung
idungnya	hidungnya
idup	hidup
idupnya	hidupnya
igtlah	ingatlah
ijap	ijab
ikut2an	ikut-ikutan
ilang	hilang
ilang "	hilang-hilang
ilang-ilang	hilang-hilang
ilang2an	hilang-hilangan
imoet	imut
imoetz	imut
imutt	imut
imutz	imut
imuut	imut
imuutt	imut
indahh	indah
indonesiaa	indonesia
indonesiaah	indonesia
ingeet	ingat
inget	ingat
inieh	ini
inih	ini
inii	ini
iniw	ini
istikamah	istiqomah
istiqamah	istiqomah
it ' s	it is
item	hitam
ituh	itu
itung	hitung
itungan	hitungan
ituu	itu
iy	iya
iyaa	iya
iyah	iya
iyak	iya
iyap	iya
iye	iya
iyh	iya
iyha	iya
iyo	iya
jaangan	jangan
jadii	jadi
jadul	zaman dulu
jadulnya	zaman dulunya
jakety	jaketnya
jaman	zaman
jangaan	jangan
jaooh	jauh
jatoh	jatuh
jatuhnyaa	jatuhnya
jauhh	jauh
jauhin	jauhi
jauuh	jauh
jawabanny	jawabannya
jd	jadi
jdi	jadi
jdikan	jadikan
jdulnya	judulnya
jdwl	jadwal
jelek " in	menjelek-jelekkan
jendes	janda
jendess	janda
jendral	jenderal
jeniuss	jenius
jg	juga
jga	juga
jgan	jangan
jgn	jangan
jgn-jgn	jangan-jangan
jgnkan	jangankan
jilbabny	jilbabnya
jilbabnyaah	jilbabnya
jilbabnye	jilbabnya
jing	anjing
jjur	jujur
jk	jika
jkrta	jakarta
jkt	jakarta
jlbb	jilbab
jlek	jelek
jln	jalan
jln-jln	jalan-jalan
jls-jls	jelas-jelas
jmnya	jamnya
jngan	jangan
jngn	jangan
jodohny	jodohnya
jodohx	jodohnya
jorokk	jorok
jrang	jarang
jt	juta
jubir	juru bicara
judulnyaa	judulnya
jugaa	juga
jugak	juga
jugakk	juga
jwab	jawab
jwb	jawab
jwban	jawaban
ka	kakak
kaan	kan
kaasian	kasihan
kab	kabupaten
kabag	kepala bagian
kabor	kabur
kacauu	kacau
kaciaan	kasihan
kacian	kasihan
kaciann	kasihan
kaciiaann	kasihan
kaciian	kasihan
kacrut	kacau
kadit	kepala direktorat
kadiv	kepala divisi
kaga	tidak
kagak	tidak
kageet	kaget
kaka	kakak
kakakny	kakaknya
kakk	kakak
kalahnye	kalahnya
kalauu	kalau
kalaw	kalau
kale	kali
kaliaan	kalian
kaliann	kalian
kalii	kali
kallo	kalau
kalo	kalau
kalogak	kalo tidak
kalok	kalau
kaloo	kalau
kalow	kalau
kalu	kalau
kalw	kalau
kamii	kami
kamo	kamu
kampungn	kampungan
kamuh	kamu
kamunyaa	kamunya
kamuu	kamu
kamuwh	kamu
kamyu	kamu
kamyuh	kamu
kanapa	kenapa
kancang	kencang
kangeen	kangen
kangeenn	kangen
kangenn	kangen
kann	kan
kanwil	kantor wilayah
kapaan	kapan
kapt	kapten
kareno	karena
karir . a	karirnya
karmaa	karma
karna	karena
kasian	kasihan
kasiann	kasihan
kasiatnya	khasiatnya
kasihn	kasihan
kata2nya	kata-katanya
kata2nyaa	kata-katanya
katanyaa	katanya
katrok	kampungan
kau	kamu
kauu	kamu
kbahagiaan	kebahagiaan
kbar	kabar
kberkahn	keberkahan
kbetulan	kebetulan
kbiasaan	kebiasaan
kcantikan	kecantikan
kcewa	kecewa
kcian	kasihan
kcil	kecil
kcwa	kecewa
kdang	kadang
kdg	kadang
kdng	kadang
kdua	kedua
kebarat2an	kebarat-baratan
kebayang	terbayang
kebongkar	terbongkar
kebukti	terbukti
kec	kecamatan
kece	cantik
kece-kece	cantik-cantik
keciil	kecil
kecik	kecil
kecill	kecil
kecptan	kecepatan
kedokk	kedok
keduaa	kedua
kedubes	kedutaan besar
keeren	keren
keinget	teringat
kejadianny	kejadiannya
kejahatn	kejahatan
kejawab	terjawab
kekeuh	keras kepala
kekuranganny	kekurangannya
keliatan	kelihatan
keliatannya	kelihatannya
keluarin	keluarkan
kemakan	termakan
kemaren	kemarin
kemariin	kemarin
kemarinn	kemarin
kemarn	kemarin
kemuh	kamu
kenaliin	kenalkan
kenalin	kenalkan
kenalinn	kenalkan
kenapaa	kenapa
kenape	kenapa
kenceng	kencang
kencng	kencang
kepd	kepada
kepikir	terpikir
kepikiran	terpikirkan
kepsek	kepala sekolah
keputihn	keputihan
kerass	keras
kereen	keren
kereenn	keren
kerenn	keren
kerjaan	pekerjaan
kesalahanny	kesalahannya
kesampean	kesampaian
kesian	kasihan
kesihan	kasihan
ketaatanny	ketaatannya
ketauan	ketahuan
ketawain	menertawakan
ketemuu	ketemu
ketipu	tertipu
ketrima	diterima
ketuker	tertukar
keukeuh	keras kepala
kgak	tidak
kgeen	kangen
kgiatan	kegiatan
kgn	kangen
khadiran	kehadiran
khadirannya	kehadirannya
khdpn	kehidupan
khidupan	kehidupan
kibul	bohong
kimpoi	kawin
kirimin	kirimkan
kitaa	kita
kite	kita
kk	kakak
kka	kakak
kkak	kakak
klahiran	kelahiran
klakuan	kelakuan
klas	kelas
klau	kalau
klauu	kalau
klen	kalian
klhran	kelahiran
klian	kalian
klianz	kalian
kliatan	kelihatan
kliatanya	kelihatannya
klihatan	kelihatan
klmbutan	kelembutan
klo	kalau
klow	kalau
klrga	keluarga
klu	kalau
kluar	keluar
kluarga	keluarga
klw	kalau
klwrga	keluarga
kmana	kemana
kmana-kmana	kemana-mana
kmaren	kemarin
kmari	kemari
kmariin	kemarin
kmarin	kemarin
kmbali	kembali
kmbang	kembang
kmewahan	kemewahan
kmps	kampus
kmpus	kampus
kmren	kemarin
kmrin	kemarin
kmrn	kemarin
kmu	kamu
knalan	kenalan
kngen	kangen
kngenn	kangen
knp	kenapa
knpa	kenapa
knyataan	kenyataan
kocaak	kocak
kocakk	kocak
kog	kok
komen-komen	komentar-komentar
komen2an	komentar-komentar
komenan	komentar
komenannya	komentarnya
konsekwensi	konsekuensi
konsul	konsultasi
koq	kok
korup	korupsi
kpada	kepada
kpan	kapan
kpancing	terpancing
kpd	kepada
kpn	kapan
kpn-kpn	kapan-kapan
kpnpun	kapanpun
kptsan	keputusan
kpuasan	kepuasan
kq	kok
kreative	kreatif
kreen	keren
kren	keren
krena	karena
krenn	keren
krenz	keren
kriput	keriput
krn	karena
krna	karena
krng	kurang
krudung	kerudung
krus	kurus
krya	karya
ksih	kasih
ksini	kesini
ksitu	kesitu
kslahan	kesalahan
kslhn	kesalahan
ksni	kesini
ksukaanmuu	kesukaanmu
ktaatan	ketaatan
ktanya	katanya
ktauan	ketahuan
ktawa	ketawa
ktemu	ketemu
ktergantungan	ketergantungan
ktika	ketika
ktny	katanya
ktnya	katanya
kuaat	kuat
kuatt	kuat
kueren	keren
kueren-kueren	keren-keren
kuq	kok
kurangin	kurangi
kusem	kusam
kususnya	khususnya
laen	lain
laenny	lainnya
lagihh	lagi
lagii	lagi
lagu2nya	lagu-lagunya
lahh	lah
lainnyaa	lainnya
lairannya	kelahirannya
laki "	laki-laki
laku "	laku-laku
lambreta	lambat
lancr	lancar
langgengg	langgeng
lanjutin	lanjutkan
lanjutkaan	lanjutkan
lanjutkann	lanjutkan
lapakk	lapak
lapas	lembaga pemasyarakatan
latgab	latihan gabungan
latian	latihan
lbih	lebih
lbihh	lebih
lbur	libur
lcu	lucu
lebh	lebih
ledekin	meledek
lengkapp	lengkap
lgkah-lgkah	langkah-langkah
lgkp	lengkap
lgsg	langsung
lgsung	langsung
lgunya	lagunya
lhir	lahir
lhirr	lahir
liat	lihat
liat ' y	lihatnya
liat-liat	lihat-lihat
liatin	lihatkan
liatlah	lihatlah
liatnya	lihatnya
liatnyaa	lihatnya
liatt	lihat
lihaat	lihat
lihaatt	lihat
lipetan	lipatan
liptsk	lipstik
lma	lama
lmyan	lumayan
lmyn	lumayan
lngkp	lengkap
lngsing	langsing
lngsung	langsung
lo	kamu
loe	kamu
lom	belum
loncaat	loncat
loncatt	loncat
lsg	langsung
lt	lantai
lu	kamu
luaarr	luar
luchu	lucu
luchuw	lucu
lucuna	lucunya
lucuny	lucunya
lucuu	lucu
lum	belum
lupain	lupakan
lurusin	luruskan
luthu	lucu
luthuna	lucunya
lutuna	lucunya
lutunaa	lucunya
maacih	terima kasih
maaciw	terima kasih
maafin	maafkan
maap	maaf
maapin	maafkan
mabes	markas besar
macem	macam
macem-macem	macam-macam
madesu	masa depan suram
maem	makan
maen	main
maennya	mainnya
mahall	mahal
mak	ibu
makany	makanya
makanyaa	makanya
makasi	terima kasih
makasih	terima kasih
maksain	memaksakan
maksd	maksud
maksih	terima kasih
malangg	malang
malem	malam
males	malas
malingg	maling
malsudnya	maksudnya
maluu	malu
mampuss	mampus
mampuus	mampu
mampuuss	mampus
maneh	kamu
manies	manis
maniez	manis
maniss	manis
mantaap	mantap
mantab	mantap
mantabs	mantap
mantaff	mantap
mantanny	mantannya
mantapp	mantap
mantaps	mantap
manteb	mantap
manteep	mantap
mantep	mantap
mantepp	mantap
marah2an	marah-marahan
masalahh	masalah
maslah	masalah
masukin	masukkan
masyaallah	masya allah
masyaallahh	masya allah
masyaalloh	masya allah
masyaaloh	masya allah
masyarakay	masyarakat
masyoallah	masya allah
matany	matanya
mataq	mataku
mateek	mati
matek	mati
matii	mati
mauu	mau
mayan	lumayan
mayann	lumayan
mblo	jomblo
mbloo	jomblo
melahirin	melahirkan
melakukn	melakukan
melebihin	melebihi
mendapatkn	mendapatkan
menegerti	mengerti
mengait2kan	mengait-ngaitkan
mengalahkn	mengalahkan
menghilangkn	menghilangkan
mengikutii	mengikuti
menjdi	menjadi
mentertawakan	menertawakan
menyenangkn	menyenangkan
merekaa	mereka
meriahh	meriah
merindingg	merinding
mesrany	mesranya
met	selamat
mgk	mungkin
mgkin	mungkin
mgkn	mungkin
milih	memilih
mimin	admin
mimpii	mimpi
miras	minuman keras
miriip	mirip
miripp	mirip
mkanya	makanya
mkin	semakin
mknya	makanya
mksd	maksud
mksdku	maksudku
mksdny	maksudnya
mksdnya	maksudnya
mksdx	maksudnya
mksh	terima kasih
mksih	terima kasih
mkst	maksud
mksud	maksud
mlah	malah
mlepaskan	melepaskan
mlikk	milik
mlm	malam
mls	malas
mmang	memang
mmbanggakan	membanggakan
mmbela	membela
mmberi	memberi
mmberikan	memberikan
mmberikn	memberikan
mmg	memang
mmperbaiki	memperbaiki
mnambh	menambah
mncoba	mencoba
mndaptkan	mendapatkan
mnding	mending
mndpat	mendapat
mndpt	mendapat
mnerima	menerima
mngerti	mengerti
mnghina	menghina
mngikuti	mengikuti
mngira	mengira
mngkannya	mangkanya
mngkin	mungkin
mngkn	mungkin
mnilai	menilai
mnis2nya	manis-manisnya
mniss	manis
mnjadi	menjadi
mnjawab	menjawab
mnjdi	menjadi
mnjdkan	menjadikan
mnjijikaan	menjijikkan
mnjmput	menjemput
mnjual	menjual
mnrtkuu	menurutku
mnta	minta
mntn	mantan
mnusuk	menusuk
mnutup	menutup
mo	mau
modes	modis
moga	semoga
mokad	mati
mokat	mati
motret	memotret
mpe	sampai
mrah	marah
mrangkul	merangkul
mreka	mereka
mrekaa	mereka
mrip	mirip
mrk	mereka
mrka	mereka
mrnghadapi	menghadapi
mrusak	merusak
msalah	masalah
msg-msg	masing-masing
msh	masih
msih	masih
mskasih	terima kasih
mskpn	meskipun
mslh	masalah
mslhnya	masalahnya
msng-msng	masing-masing
msuk	masuk
muahal	mahal
muall	mual
muantaap	mantap
muantab	mantap
muantap	mantap
muantep	mantap
muantteepp	mantap
mubes	musyawarah besar
mudaa	muda
mudah " an	mudah-mudahan
mudah " n	mudah-mudahan
mudah2an	mudah-mudahan
mudah2n	mudah-mudahan
mudh " an	mudah-mudahan
muga	semoga
muka "	muka-muka
mukae	mukanya
mukanyaa	mukanya
mukax	mukanya
muke	muka
muliany	mulianya
mulu	melulu
muluss	mulus
mulutny	mulutnya
mulutnyaa	mulutnya
muluu	melulu
mumpung	selagi
muna	munafik
munaafikk	munafik
munafikk	munafik
munafiq	munafik
munas	musyawarah nasional
munaslub	musyawarah nasional luar biasa
mungki	mungkin
mungkiin	mungkin
munkinn	munkin
muraah	murah
murahh	murah
murmer	murah meriah
mutihin	memutihkan
mutuain	memutuskan
mutusin	memutuskan
muup	maaf
muupz	maaf
muuv	maaf
mw	mau
n	dan
naahh	nah
naek	naik
nafass	nafas
nafkahin	menafkahi
naggung	menanggung
nagiss	menangis
nahan	menahan
nahann	menahan
nahh	nah
najiis	najis
najiss	najis
nakutin	menakuti
nal	kenal
nama "	nama-nama
namain	menamai
namany	namanya
namax	namanya
namnya	namanya
nampar	menampar
nanam	menanam
nanget	banget
nanggepin	menanggapi
nangiis	menangis
nangiiss	menangis
nangis	menangis
nangis "	menangis-nangis
nantangin	menantang
nantii	nanti
naon	apa
napa	kenapa
napi	narapidana
napol	narapidana politik
napsuu	napsu
nari	menari
narik	menarik
nasehatin	menasihati
nasgor	nasi goreng
natap	menatap
naturall	natural
nawarin	menawari
nda	tidak
ndak	tidak
ndiri	sendiri
ndukung	mendukung
ndut	gemuk
negri	negeri
nekolim	neokolonialisme
nekolin	neokolonialisme
nelfon	menelepon
nembak	menembak
nempel	menempel
nemuin	menemukan
nenek "	nenek-nenek
nengok	menengok
nentuin	menentukan
nerawang	menerawang
nerima	menerima
nerusin	meneruskan
netaas	menetas
netes	menetes
ngabis2in	menghabiskan
ngaca	mengaca
ngacaa	mengaca
ngadain	mengadakan
ngadu	mengadu
ngajak	mengajak
ngajar	mengajar
ngajarin	mengajari
ngaji	mengaji
ngajuin	mengajukan
ngak	tidak
ngaku	mengaku
ngaku "	mengaku-ngaku
ngalah	mengalah
ngalahin	mengalahi
ngalir	mengalir
ngalirr	mengalir
ngamatin	mengamati
ngambek	marah
ngambekan	marahan
ngambeknya	marahnya
ngambil	mengambil
nganggepin	menanggapi
ngantar	mengantar
ngantri	mengantri
ngapus	menghapus
ngarang	mengarang
ngarep	mengharap
ngarepp	mengharap
ngarsipin	mengarsipkan
ngaruh	berpengaruh
ngasih	memberi
ngata2i	mengata-ngatai
ngata2in	mengata-ngatai
ngatai	mengatai
ngatain	mengatai
ngatur	mengatur
ngayal	mengkhayal
ngcpin	mengucapkan
ngebales	membalas
ngebantu	membantu
ngebedain	membedakan
ngebela	membela
ngebenci	membenci
ngebiarin	membiarkan
ngebolehin	membolehkan
ngebuktiin	membuktikan
ngecek	mengecek
ngeditnya	mengeditnya
ngedukung	mendukung
ngegampar	menggampar
ngegantiin	menggantikan
ngegemesin	menggemaskan
ngegmesin	menggemaskan
ngehakimi	menghakimi
ngehancurin	menghancurkan
ngehina	menghina
ngehujat	menghujat
ngeidealin	mengidealkan
ngejatuhin	menjatuhkan
ngejelek2in	menjelek-jelekkan
ngejilat	menjilat
ngejuangin	memperjuangkan
ngeklaim	mengklaim
ngelahirin	melahirkan
ngelakuin	melakukan
ngelamar	melamar
ngelaporin	melaporkan
ngelarang	melarang
ngelawak	melawak
ngelawan	melawan
ngelewati	melewati
ngeliat	melihat
ngeliatin	melihat
ngeliatnya	melihatnya
ngelidur	mengigau
ngelihat	melihat
ngelihatnya	melihatnya
ngelindur	mengigau
ngeluarin	mengeluarkan
ngelucu	melucu
ngepake '	memakai
ngerampas	merampas
ngerampok	merampok
ngerasa	merasa
ngerasain	merasakan
ngerayain	merayakan
ngerebut	merebut
ngerendahin	merendahkan
ngerespon	merespon
ngerii	seram
ngerri	seram
ngerrii	seram
ngerti	mengerti
ngertii	mengerti
ngertiin	mengerti
ngerussak	merusak
ngeselin	mengesalkan
nget	banget
ngetik	mengetik
ngets	banget
ngetsz	banget
ngg	tidak
ngga	tidak
nggaak	tidak
nggak	tidak
nggakk	tidak
nggali	menggali
nggk	tidak
ngidam	mengidam
ngidealkan	mengidealkan
ngikutin	mengikuti
ngilang	menghilang
ngilangin	menghilangkan
nginep	menginap
ngingetin	mengingatkan
nginjek	menginjak
ngintip	mengintip
ngirim	mengirim
ngiringan	mengiringi
ngiritya	mengiritnya
ngisi	mengisi
ngk	tidak
ngobrol	mengobrol
ngoceh	mengoceh
ngocok	mengocok
ngomen	mengomentari
ngomenin	mengomentari
ngomentarin	mengomentari
ngomongin	membicarakan
ngorbanin	mengorbankan
ngrebut	merebut
ngrti	mengerti
ngrusak	merusak
ngrusin	mengurusi
ngtain	mengatai
ngtif	negatif
ngucapin	mengucapkan
ngulangin	mengulangi
ngumbar	mengumbar
ngumbar-ngumbar	mengumbar-umbar
ngumpat-ngumpat	mengumpat-umpat
ngungkit-ngungkit	mengungkit-ungkit
ngurusin	mengurusi
nich	nih
niech	nih
nihh	nih
niih	nih
niihh	nih
nikaah	nikah
nikahin	menikahi
nikmatin	menikmati
ninggalin	meninggalkan
ninggiin	meninggikan
niru	meniru
njay	anjay
njayy	anjay
njer	anjir
njerr	anjir
njiirr	anjir
njir	anjir
njirr	anjir
nkah	nikah
nmnya	namanya
nmr	nomor
nnt	nanti
nnti	nanti
nntn	menonton
nnton	menonton
nonton	menonton
nontonny	menontonnya
nontonx	menontonnya
nontonya	menontonnya
novembr	november
nraktir	mentraktir
ntab	mantap
ntaf	mantap
ntah	entah
ntap	mantap
ntaps	mantap
ntar	nanti
ntik	cantik
ntikk	cantik
nton	menonton
nuduh	menuduh
nuhun	terima kasih
nulis	menulis
nunduk	menunduk
nunggu	menunggu
nungguin	menunggu
nuntut	menuntut
nusuk	menusuk
nutup " in	menutup-nutupi
nutupin	menutupi
ny	nya
nyaa	nya
nyakitin	menyakiti
nyalahin	menyalahi
nyambet	menyambat
nyambung	menyambung
nyampe	sampai
nyampein	menyampaikan
nyampenya	sampainya
nyangka	menyangka
nyangkaa	menyangka
nyaranin	menyarankan
nyari	mencari
nyatakan	menyatakan
nyatok	mencatok
nyebelin	menyebalkan
nyebur	mencebur
nyebut-nyebut	menyebut-nyebut
nyekar	menyekar
nyela	mencela
nyenengin	menyenangkan
nyerang	menyerang
nyesel	menyesal
nyesell	menyesal
nyia2in	menyia-nyiakan
nyicil	mencicil
nyimak	menyimak
nyimpen	menyimpan
nyindir	menyindir
nyiram	menyiram
nyoba	mencoba
nyoblos	mencoblos
nyok	ayo
nyokap	ibu
nyubit	mencubit
nyubitt	mencubit
nyusahhin	menyusahkan
nyusahin	menyusahkan
nyusul	menyusul
ol	online
omdo	omong doang
oon	bodoh
oprasi	operasi
oprasiya	operasinya
orabg	orang
orangg	orang
org-org	orang-orang
orgny	orangnya
orlaen	orang lain
orng	orang
ortu	orang tua
ortuny	orang tuanya
ortunya	orang tuanya
owh	oh
paati	pasti
pacara	pacaran
pacarane	pacarannya
pacaranya	pacarannya
pacarn	pacaran
pacarnyaa	pacarnya
pacarr	pacar
padahall	padahal
padahl	padahal
padet	padat
padhe	pakde
padhl	padahal
pahalax	pahalanya
pahamin	pahami
pait	pahit
pake	pakai
pakek	pakai
pakke	pakai
pala	kepala
palinf	paling
pandanginya	memandanginya
panggilan ' y	panggilannya
panggilan ' ya	panggilannya
pankapan	kapan-kapan
pantes	pantas
pantess	pantas
paraah	parah
parahh	parah
pas2an	pas-pasan
pasangn	pasangan
pastii	pasti
payahh	payah
pcar	pacar
pcaran	pacaran
pcaranya	pacarannya
pcarny	pacarnya
pcran	pacaran
pcrnya	pacarnya
pdahal	padahal
pdhal	padahal
pdhall	padahal
pdhl	padahal
pedes	pedas
peengn	ingin
pelastik	plastik
pelem	film
peliharaa	pelihara
pelwak	pelawak
pemainy	pemainnya
pembokat	pembantu
penasarann	penasaran
penasarn	penasaran
penbelian	pembelian
pengalam	pengalaman
penganten	pengantin
pengeen	ingin
pengeenn	ingin
pengen	ingin
pengenn	ingin
pengennya	inginnya
penghrgaan	penghargaan
pengikuy	pengikut
pensaran	penasaran
pentingg	penting
penyakitny	penyakitnya
peragain	peragakan
perasaanny	perasaannya
perbaikin	perbaiki
percya	percaya
perhatiin	perhatikan
perilakuny	perilakunya
pernikahn	pernikahan
personill	personil
pertamany	pertamanya
pertamax	pertama
pertma	pertama
pesen	pesan
pesenan	pesanan
pesenin	pesankan
pgang	pegang
pilihanny	pilihannya
pilihnmu	pilihanmu
pilm	film
pingin	ingin
pinginn	ingin
pinter	pintar
pintr	pintar
pjg	panjang
pkai	pakai
pkoknya	pokoknya
pkoknyaa	pokoknya
pkrin	pikirkan
pla	pula
plampiasann	pelampiasan
pling	paling
pljaran	pelajaran
pljrn	pelajaran
plsa	pulsa
pmbantu	pembantu
pmbelajaran	pembelajaran
pmbyran	pembayaran
pmrnth	pemerintah
pndapat	pendapat
pngen	ingin
pngenn	ingin
pnjang	panjang
pnjng	panjang
pnjual	penjual
pnting	penting
pnuh	penuh
pny	punya
pnya	punya
pnyaa	punya
positip	positif
positipp	positif
prasaan	perasaan
prawatan	perawatan
prcuma	percuma
prcy	percaya
prcya	percaya
prempuan	perempuan
prhatian	perhatian
priksa	periksa
prjuangan	perjuangan
prlu	perlu
prmpuan	perempuan
prnah	pernah
prnh	pernah
prodaknya	produknya
prsatukn	persatukan
prwatn	perawatan
prwtn	perawatan
psangan	pasangan
pst	pasti
psti	pasti
pswt	pesawat
puanas	panas
pucing	pusing
pulaa	pula
pulak	pula
punyaa	punya
pusingg	pusing
putihh	putih
putihnyaa	putihnya
pyudara	payudara
q	aku
qm	kamu
qmo	kamu
qmu	kamu
qo	kok
qt	kita
qta	kita
qu	aku
rame	ramai
rame-rame	ramai-ramai
rb	ribu
recomendasinya	rekomendasinya
recommendasi	rekomendasi
redho	ridho
rehab	rehabilitasi
rejeki	rezeki
relaa	rela
rempong	repot
repong	repot
rezeqinya	rezekinya
rezki	rezeki
rhs	rahasia
rinduu	rindu
rmbt	rambut
rmbut	rambut
rmbutnya	rambutnya
rmbuut	rambut
rmh	rumah
romantisny	romatisnya
romantiss	romantis
romantiz	romantis
romntis	romantis
rumh	rumah
rupa2nya	rupa-rupanya
rusakk	rusak
s3ndiri	sendiri
sabaar	sabar
sabaarr	sabar
sabarr	sabar
sahabatt	sahabat
saia	aku
saiank	sayang
salaam	salam
salahin	salahkan
salfok	salah fokus
salluutt	salut
salting	salah tingkah
samaa	sama
samoga	semoga
sampe	sampai
sampein	sampaikan
sampeyan	kamu
samsek	sama sekali
sangaat	sangat
sangaatt	sangat
sangatt	sangat
saranin	sarankan
satuu	satu
saudra	saudara
saya	aku
sayaa	aku
sayaang	sayang
sayangkuh	sayangku
sayangq	sayangku
sayangx	sayangnya
sbagai	sebagai
sbaiknya	sebaiknya
sbelah	sebelah
sbelum	sebelum
sbenernya	sebenarnya
sbg	sebagai
sbgai	sebagai
sblah	sebelah
sblh	sebelah
sblm	sebelum
sblmny	sebelumnya
sblmnya	sebelumnya
sblum	sebelum
sbnarnya	sebenarnya
sbnrny	sebenarnya
sbnyak	sebanyak
sbr	sabar
sbuah	sebuah
scara	secara
scpatny	secepatnya
scr	secara
scra	secara
sdah	sudah
sdg	sedang
sdgkn	sedangkan
sdh	sudah
sdkit	sedikit
sdkit-sdkit	sedikit-sedikit
sdkt	sedikit
sdngkn	sedangkan
sdri	sendiri
se7	setuju
seandainy	seandainya
sebelum2nya	sebelum-sebelumnya
sebelumbya	sebelumnya
sebenernya	sebenarnya
sebnyak	sebanyak
sedangkn	sedangkan
sedihh	sedih
seger	segar
segerr	segar
seharusny	seharusnya
sekali-sekali	sekali-kali
sekarng	sekarang
sekjen	sekretaris jenderal
sekolahin	sekolahkan
sekrang	sekarang
sekrng	sekarang
seksii	seksi
selaloe	selalu
selaluu	selalu
selmat	selamat
selmnya	selamanya
selmt	selamat
seluru	seluruh
semangaat	semangat
semangaatt	semangat
semangatt	semangat
semngat	semangat
semogaa	semoga
sempet	sempat
sempet2nya	sempat-sempatnya
sempurnaa	sempurna
semuannyaa	semuanya
sendirii	sendiri
sendirinnya	sendirinya
sendirinyya	sendirinya
seneeng	senang
seneng	senang
senengg	senang
seorg	seorang
serem	seram
seru2an	seru-seruan
seruu	seru
sesatt	sesat
sesek	sesak
sesekk	sesak
setabil	stabil
setju	setuju
setujuu	setuju
sexi	seksi
sexi-sexi	seksi-seksi
sexxi	seksi
sgampang	segampang
sgla	segala
sgt	sangat
shabat	sahabat
sharusnya	seharusnya
shat	sehat
shbat	sahabat
shbt	sahabat
shg	sehingga
sia2kan	sia-siakan
siapaa	siapa
sibukx	sibuknya
sich	sih
sidak	inspeksi mendadak
siech	sih
sieyh	sih
sihh	sih
siih	sih
siihh	sih
silahkan	silakan
silahkn	silakan
silsturahmi	silaturahmi
simpen	simpan
siriik	sirik
sirikk	sirik
sja	saja
skali	sekali
skali-skali	sekali-kali
skalian	sekalian
skaligus	sekaligus
skalii	sekali
skarang	sekarang
skedar	sekadar
skg	sekarang
skitar	sekitar
skl	sekali
sklh	sekolah
sklinyaa	sekalinya
skluarga	sekeluarga
skolah	sekolah
skr	sekarang
skrang	sekarang
skrg	sekarang
skrng	sekarang
sktika	seketika
skul	sekolah
slalu	selalu
slamat	selamat
slamet	selamat
slesai	selesai
slh	salah
sling	saling
sllu	selalu
slma	selama
slmat	selamat
slmt	selamat
slsai	selesai
smakin	semakin
smangat	semangat
smbil	sambil
smentara	sementara
smg	semoga
smga	semoga
smgaa	semoga
smkin	semakin
smngat	semangat
smnjak	semenjak
smog	semoga
smoga	semoga
smpai	sampai
smpe	sampai
smpt	sempat
smrg	semarang
smster	semester
smua	semua
smula	semula
sna	sana
sndiri	sendiri
sndr	sendiri
sndri	sendiri
sneng	senang
sngaja	sengaja
sngt	sangat
soalx	soalnya
sok2an	sok-sokan
sokk	sok
somse	sombong sekali
songong	sombong
sotoy	sok tahu
sowry	maaf
sperti	seperti
spertinya	sepertinya
sprti	seperti
spt	seperti
spti	seperti
spy	supaya
srng	sering
srta	serta
srtfkt	sertifikat
ssorg	seseorang
sstu	sesuatu
staf2nya	staf-stafnya
stagahh	astaga
statusx	statusnya
stelah	setelah
stiap	setiap
stidaknya	setidaknya
stimpal	setimpal
stju	setuju
stlh	setelah
stp	setiap
stress	stres
sttus	status
stuju	setuju
suamii	suami
suaminga	suaminya
suaminy	suaminya
suaranyaa	suaranya
subahanallah	subhanallah
subhanaallahh	subhanallah
subhanalloh	subhanallah
subhannallah	subhanallah
subhnallah	subhanallah
sucses	sukses
sudh	sudah
suipit	sipit
sukaa	suka
sukkaa	suka
sukse	sukses
suksea	sukses
suksess	sukses
sumbangin	sumbangkan
sumpahh	sumpah
sumvahh	sumpah
supeer	super
surgaa	surga
sweger	segar
swmntara	sementara
sya	aku
syang	sayang
syantiek	cantik
syantiikk	cantik
syantik	cantik
syediih	sedih
syediihh	sedih
syekalii	sekali
syg	sayang
sygkuu	sayangku
syng	sayang
syngnya	sayangnya
synk	sayang
syratnya	syaratnya
t4	tempat
taek	tahi
taekk	tahi
tai	tahi
taii	tahi
taik	tahi
takutt	takut
takuut	takut
tambahh	tambah
tambahim	tambahkan
tambahin	tambahkan
tambh	tambah
tampialannya	tampilannya
tamvann	tampan
tanda2nya	tanda-tandanya
tangkep	tangkap
tantee	tante
tanteny	tantenya
tanyain	tanyakan
taon	tahun
tapii	tapi
tar	nanti
tau	tahu
taun	tahun
tauu	tahu
taux	tahunya
tbuh	tubuh
td	tadi
tdak	tidak
tdi	tadi
tdk	tidak
tdr	tidur
tdur	tidur
te2p	tetap
tebel	tebal
tegaar	tegar
tehh	teh
telefisi	televisi
telimakacih	terima kasih
tembemm	tembem
tembokk	tembok
temen	teman
temen "	teman-teman
temen-temen	teman-teman
temenkuuh	temanku
temenn	teman
temennya	temannya
tempt	tempat
tengaj	tengah
tentanh	tentang
terangkhn	terangkan
terbaek	terbaik
terbaeq	terbaik
terbaiik	terbaik
terbaikk	terbaik
terbitin	terbitkan
terhaaru	terharu
terharuu	terharu
terimaksih	terima kasih
teringet	teringat
teringt	teringat
terjrumus	terjerumus
terkenall	terkenal
termuraah	termurah
termuraahh	termurah
termurahh	termurah
ternyataa	ternyata
terong2an	terong-terongan
teros	terus
teross	terus
terrbaik	terbaik
terus2an	terus-terusan
teruss	terus
teruz	terus
teruzz	terus
testi	testimoni
testinya	testimoninya
tetaplaah	tetaplah
tetapp	tetap
tetep	tetap
tetp	tetap
tggu	tunggu
tgk	tengok
tgu	tunggu
thanks	terima kasih
thankz	terima kasih
thd	terhadap
thdp	terhadap
thn	tahun
thnan	tahunan
thun	tahun
thx	terima kasih
tidakk	tidak
tiga2nya	tiga-tiganya
tinggalin	tinggalkan
tinggalkn	tinggalkan
tinggall	tinggal
tinggl	tinggal
tipiwan	tvone
tipu2nya	tipu-tipunya
tks	terima kasih
tkut	takut
tlg	tolong
tlp	telepon
tlpn	telepon
tls	tulis
tlsn	tulisan
tman	teman
tmbah	tambah
tmbh	tambah
tmen	teman
tmen-tmen	teman-teman
tmn	teman
tmn-tmn	teman-teman
tmn2nya	teman-temannya
tmpt	tempat
tnang	tenang
tnggu	tunggu
tnh	tanah
tnp	tanpa
tnpa	tanpa
tntg	tentang
tntram	tenteram
tnya	tanya
tnyta	ternyata
tohh	toh
tokai	tahi
tokayy	tahi
tolernsi	toleransi
tpii	tapi
tq	terima kasih
trasa	terasa
trbaik	terbaik
trbaikk	terbaik
trbukti	terbukti
trdhulu	terdahulu
trganggu	terganggu
trgntg	tergantung
trhtung	terhitung
trima	terima
trims	terima kasih
trjadi	terjadi
trjd	terjadi
trknal	terkenal
trkrim	terkirim
trlalu	terlalu
trlihat	terlihat
trll	terlalu
trmanis	termanis
trmasuk	termasuk
trmsuk	termasuk
trnyata	ternyata
trnyt	ternyata
troma	trauma
trpsah	terpisah
trserah	terserah
trserh	terserah
trsrh	terserah
trus	terus
truss	terus
trutama	terutama
trz	terus
tsb	tersebut
ttap	tetap
ttd	tertanda
ttep	tetap
ttg	tentang
tuch	tuh
tuhanny	tuhannya
tuhh	tuh
tuk	untuk
tukan	tukang
tullus	tulus
tumpe-tumpe	tumpah-tumpah
tunjukan	tunjukkan
tunjukin	tunjukkan
tutorialx	tutorialnya
tuu	tuh
tuuh	tuh
tuwh	tuh
tw	tahu
uapik	bagus
ucul	lucu
ucull	lucu
udah	sudah
udah-udah	sudah-sudah
udahh	sudah
udahlah	sudahlah
udeh	sudah
udehh	sudah
udh	sudah
uitnya	duitnya
ujg	ujung
ujung2nya	ujung-ujungnya
ultah	ulang tahun
ungkapin	ungkapkan
univ	universitas
untk	untuk
urang	aku
urat2nya	urat-uratnya
urg	aku
ursan	urusan
urusanny	urusannya
urusn	urusan
utang	hutang
utk	untuk
utkmu	untukmu
vol	volume
w	aku
wajiib	wajib
waktunyaa	waktunya
wanitah	wanita
wanjerr	anjir
wanjiir	anjir
wanjir	anjir
warbiyasah	luar biasa
warnaa	warna
warnany	warnanya
wat	buat
wjh	wajah
wktu	waktu
wktunya	waktunya
wlau	walau
wlaupun	walaupun
wlawpun	walaupun
wlo	walau
wlwpun	walaupun
wrn	warna
wuastagah	astaga
ya	iya
yaa	iya
yaampun	iya ampun
yaampunn	ya ampun
yaampuun	ya ampun
yaang	yang
yakinn	yakin
yaoloh	iya allah
yaolohh	iya allah
yap	iya
yapz	iya
yaudah	iya sudah
yaudh	iya sudah
yauwda	iya sudah
yawdah	iya sudah
yawlah	iya allah
yawloh	iya allah
yg	yang
yng	yang
yok	ayo
yokk	ayo
yowes	iya sudah
yq	yang
yuk	ayo
yukk	ayo
yuks	ayo
yukss	ayo
yup	iya
yuppss	iya
z	saja
za	saja